########################################################################
#            #     #                #                                  #
#            #     #                 #               # # #             #
#            #     #        #         #             # # # #            #
#            #     #       ##          #             # # #             #
#            #     #      ###           #       #   # # # #   #        #
####   #######     #     #######         #       #   # # #   #         #
#                  #           #          #       #    #    #          #
#                  #           #          #        #########           #
#                              #          #            #               #
#                ###############  #       #            #               #
#####   #####    #                #                    #               #
#           #    #  ###############       #            #               #
#           #    #                #       #           # #              #
#           #    ###############  #       #          #   #             #
#####       #    #                #       #         #     #            #
#   #       #    #                #       #        #       #           #
# A         #    #######   ########       #       #         #          #
#   #       #                             #    ###           ###       #
########################################################################
