################################################################################
#                ##############         #######################                #
#                ##############         ###########       #####                #
#                #####     ####         #      ####       #####                #
#                    #     ####         #      ####       #####                #
#                #####     ####         #      ####       ############# ########
######### ############                  #                                     ##
###                ###     ####         #      ####       ##                  ##
###                ###     ####                ####       ##                  ##
###                        ####         #      #############                  ##
######### ################################ #################            A     ##
##                 ####################### #####################################
##                 ###########       #####                #####              ###
##                 ##     ####       #####                #####              ###
##                        ####       #####                                   ###
##                 ##     ####                            #####              ###
########## ##########                #####                #####              ###
###               ###     ####       ######## ##################################
###               ###     ####                                                 #
################################################################################
