                                                                         #      
  ###      ##  ###      #    #     ###                     #      #     ###  ## 
          ##########   #          ###  ###  ###    ####    ###   ###         ## 
 #       ####  #####     #     #####   ###  ##########     #### ########     ###
##       ###       #           ####    ### ########## # #  ##### ######     ####
 ##     ###                    ###         ##    ###         #             #### 
 ####  ####                     ##                 #                       ###  
 ###########                 # # #                              #          ##   
 ##########                           ###           ###             ##      #   
 ##########     ##   #         #    ######  #    ########         #####     #   
 ##########          #         ##  ##########   ########         #######    #   
 ######                        ##############   ########      ##############    
                     ####      ##############   ######   %    ###############   
                     ####      ##############    ####         ###############   
          ######     #####    ###############     ###            #############  
    ############    #######    ###############    ###       ##    ############# 
    ############ # ########## # #   ###########   ###     ###     ##   #########
   #############    ##########        #####   #    ###    ###           ####### 
  #####  #######   # ##   ##### #       ##         ###   ####       #   ###     
   #                        #                       #                   #       
