########################################################################
#            #     #                #                                  #
#            #     #                 #               # # #             #
#            #     #                  #             # # # #            #
#            #     #                   #             # # #             #
#            #     #                    #       #   # # # #   #        #
#####  #######     #     #######         #       #   # # #   #         #
#                  #           #          #       #    #    #          #
#                  #           #          #        #########           #
#     %                        #          #            #               #
#                ###############  #       #            #               #
######  #####    #                #                    #               #
#           #    #  ###############       #            #               #
#           #    #                #       #           # #              #
#           #    ###############  #       #          #   #             #
######      #    #                #       #         #     #            #
#    #      #    #                #       #        #       #           #
#           #    #######   ########       #       #         #          #
#    #      #                             #    ###           ###       #
########################################################################
